owner,repo_name,pull_number,url,state,revision_commit,revision_total_additions,revision_total_deletions,revision_total_change_lines,revision_file_change,Co-authored commits number,initial_total_additions,initial_total_deletions,initial_change_lines,initial_file_change
567-labs,instructor,831,https://github.com/567-labs/instructor/pull/831,MERGED,4,567,187,754,4,0,0,0,0,0
567-labs,instructor,1030,https://github.com/567-labs/instructor/pull/1030,MERGED,5,205,201,406,3,0,47,83,130,2
567-labs,instructor,1095,https://github.com/567-labs/instructor/pull/1095,MERGED,14,372,388,760,4,0,184,9,193,7
567-labs,instructor,1369,https://github.com/567-labs/instructor/pull/1369,MERGED,5,8779,7382,16161,130,0,2880,486,3366,24
567-labs,instructor,1378,https://github.com/567-labs/instructor/pull/1378,MERGED,5,215,511,726,0,0,1013,85,1098,12
567-labs,instructor,1430,https://github.com/567-labs/instructor/pull/1430,MERGED,3,70,66,136,0,0,111,0,111,1
84codes,crystal-packages,25,https://github.com/84codes/crystal-packages/pull/25,MERGED,1,3,10,13,0,0,21,26,47,2
ApeWorX,ape,2534,https://github.com/ApeWorX/ape/pull/2534,MERGED,9,489,148,637,11,3,0,0,0,0
Erlemar,pytorch_tempest,66,https://github.com/Erlemar/pytorch_tempest/pull/66,MERGED,1,6,4,10,2,0,23,2,25,4
INCATools,ontology-access-kit,749,https://github.com/INCATools/ontology-access-kit/pull/749,MERGED,1,4,4,8,0,0,317,0,317,3
MaiM-with-u,MaiBot,174,https://github.com/MaiM-with-u/MaiBot/pull/174,MERGED,1,284,198,482,20,0,1,1,2,1
MinBZK,poc-machine-law,18,https://github.com/MinBZK/poc-machine-law/pull/18,MERGED,3,436,204,640,3,0,338,4,342,7
Nayshins,ummon,48,https://github.com/Nayshins/ummon/pull/48,MERGED,1,2,54,56,2,0,108,325,433,2
OpenPipe,ART,44,https://github.com/OpenPipe/ART/pull/44,MERGED,1,5,0,5,1,0,39,4,43,4
OpenPipe,ART,52,https://github.com/OpenPipe/ART/pull/52,MERGED,10,4081,4004,8085,19,0,0,0,0,0
PipedreamHQ,pipedream,12212,https://github.com/PipedreamHQ/pipedream/pull/12212,MERGED,11,85,147,232,8,0,56,0,56,2
PipedreamHQ,pipedream,13882,https://github.com/PipedreamHQ/pipedream/pull/13882,MERGED,2,4,4,8,0,0,60,24,84,4
PipedreamHQ,pipedream,13891,https://github.com/PipedreamHQ/pipedream/pull/13891,MERGED,1,2,2,4,0,0,2,10,12,2
PolicyEngine,policyengine-app,1967,https://github.com/PolicyEngine/policyengine-app/pull/1967,MERGED,1,2,3,5,0,0,53,0,53,3
SoftFever,OrcaSlicer,6554,https://github.com/SoftFever/OrcaSlicer/pull/6554,MERGED,1,1,1,2,0,0,287,6,293,20
SpinaCMS,Spina,1400,https://github.com/SpinaCMS/Spina/pull/1400,MERGED,4,15,17,32,3,0,254,208,462,7
Tiberriver256,mcp-server-azure-devops,161,https://github.com/Tiberriver256/mcp-server-azure-devops/pull/161,MERGED,4,30,103,133,0,0,391,10,401,10
Tiberriver256,mcp-server-azure-devops,166,https://github.com/Tiberriver256/mcp-server-azure-devops/pull/166,MERGED,2,154,14,168,3,0,352,1,353,8
Wan-Video,Wan2.1,44,https://github.com/Wan-Video/Wan2.1/pull/44,MERGED,1,0,1,1,0,0,2,0,2,1
aklinker1,bunv,2,https://github.com/aklinker1/bunv/pull/2,MERGED,2,3,5,8,0,0,44,21,65,1
aklinker1,bunv,3,https://github.com/aklinker1/bunv/pull/3,MERGED,1,3,1,4,0,0,29,0,29,2
aklinker1,bunv,10,https://github.com/aklinker1/bunv/pull/10,MERGED,6,38,11,49,2,0,14,1,15,1
aleph-im,aleph-vm,680,https://github.com/aleph-im/aleph-vm/pull/680,MERGED,3,18,6,24,1,0,2,17,19,2
aleph-im,pyaleph,599,https://github.com/aleph-im/pyaleph/pull/599,MERGED,1,10,5,15,1,0,5,1,6,1
alexei-led,aws-mcp-server,8,https://github.com/alexei-led/aws-mcp-server/pull/8,MERGED,3,289,29,318,0,1,2489,591,3080,18
alexei-led,k8s-mcp-server,2,https://github.com/alexei-led/k8s-mcp-server/pull/2,MERGED,6,64,68,132,2,0,406,62,468,4
alexfedosov,move-tool,3,https://github.com/alexfedosov/move-tool/pull/3,MERGED,3,124,133,257,4,0,552,0,552,10
allenai,open-instruct,422,https://github.com/allenai/open-instruct/pull/422,MERGED,1,5,5,10,0,0,17,6,23,2
anthropics,devcontainer-features,4,https://github.com/anthropics/devcontainer-features/pull/4,MERGED,1,3,0,3,0,0,7,8,15,1
artsy,eigen,10595,https://github.com/artsy/eigen/pull/10595,MERGED,1,6,3,9,0,0,86,5,91,4
artsy,eigen,11810,https://github.com/artsy/eigen/pull/11810,MERGED,1,21,0,21,1,0,18,5,23,2
artsy,force,14112,https://github.com/artsy/force/pull/14112,MERGED,5,96,93,189,11,0,0,0,0,0
basicmachines-co,basic-memory,6,https://github.com/basicmachines-co/basic-memory/pull/6,MERGED,1,81,77,158,0,0,393,354,747,13
beekeeper-studio,beekeeper-studio,2361,https://github.com/beekeeper-studio/beekeeper-studio/pull/2361,MERGED,3,436,122,558,40,0,47,64,111,3
beekeeper-studio,beekeeper-studio,2803,https://github.com/beekeeper-studio/beekeeper-studio/pull/2803,MERGED,7,164,116,280,6,0,512,484,996,15
beekeeper-studio,beekeeper-studio,2853,https://github.com/beekeeper-studio/beekeeper-studio/pull/2853,MERGED,12,209,97,306,9,1,6,2,8,2
brentyi,jaxls,17,https://github.com/brentyi/jaxls/pull/17,MERGED,4,174,38,212,3,0,0,0,0,0
brentyi,tyro,182,https://github.com/brentyi/tyro/pull/182,MERGED,7,82,82,164,1,0,457,254,711,10
brentyi,tyro,187,https://github.com/brentyi/tyro/pull/187,MERGED,2,8,2,10,0,0,59,1,60,3
brentyi,tyro,189,https://github.com/brentyi/tyro/pull/189,MERGED,12,815,564,1379,12,0,1043,1024,2067,22
brentyi,tyro,194,https://github.com/brentyi/tyro/pull/194,MERGED,2,331,1,332,4,0,462,622,1084,33
brentyi,tyro,199,https://github.com/brentyi/tyro/pull/199,MERGED,1,10,10,20,0,0,204,183,387,28
brentyi,tyro,201,https://github.com/brentyi/tyro/pull/201,MERGED,4,71,69,140,2,0,641,182,823,22
brentyi,tyro,208,https://github.com/brentyi/tyro/pull/208,MERGED,1,10,6,16,2,0,61,39,100,6
brentyi,tyro,211,https://github.com/brentyi/tyro/pull/211,MERGED,3,132,144,276,7,0,25,24,49,3
brentyi,tyro,217,https://github.com/brentyi/tyro/pull/217,MERGED,1,2,2,4,0,0,42,21,63,5
brentyi,tyro,219,https://github.com/brentyi/tyro/pull/219,MERGED,1,12,4,16,2,0,126,41,167,10
brentyi,tyro,225,https://github.com/brentyi/tyro/pull/225,MERGED,2,2,2,4,0,0,38,22,60,1
brentyi,tyro,246,https://github.com/brentyi/tyro/pull/246,MERGED,6,66,30,96,4,0,57,7,64,4
brentyi,tyro,255,https://github.com/brentyi/tyro/pull/255,MERGED,2,15,0,15,1,0,5,2,7,1
brentyi,tyro,256,https://github.com/brentyi/tyro/pull/256,MERGED,3,40,11,51,2,0,46,8,54,2
coder,coder,13685,https://github.com/coder/coder/pull/13685,MERGED,1,9,0,9,3,0,3,0,3,1
coder,coder,13749,https://github.com/coder/coder/pull/13749,MERGED,8,417,296,713,6,0,1049,1892,2941,4
coder,coder,14786,https://github.com/coder/coder/pull/14786,MERGED,6,29,48,77,1,0,42,4,46,1
coder,coder,14928,https://github.com/coder/coder/pull/14928,MERGED,23,1765,1636,3401,12,0,768,18,786,9
coder,coder,15101,https://github.com/coder/coder/pull/15101,MERGED,17,3608,2356,5964,113,0,0,0,0,0
coder,coder,15415,https://github.com/coder/coder/pull/15415,MERGED,1,0,0,0,0,0,9,0,9,2
coder,coder,16187,https://github.com/coder/coder/pull/16187,MERGED,3,13,13,26,0,0,39,64,103,9
coder,coder,16563,https://github.com/coder/coder/pull/16563,MERGED,10,157,60,217,21,0,0,0,0,0
coder,coder,17223,https://github.com/coder/coder/pull/17223,MERGED,1,1,1,2,0,0,27,27,54,9
coder,coder,17356,https://github.com/coder/coder/pull/17356,MERGED,3,2,2,4,0,0,5,5,10,4
coder,modules,311,https://github.com/coder/modules/pull/311,MERGED,1,4,4,8,1,0,1,1,2,1
coder,packages,163,https://github.com/coder/packages/pull/163,MERGED,3,4,4,8,0,0,18,14,32,1
coder,vscode-coder,421,https://github.com/coder/vscode-coder/pull/421,MERGED,2,2,2,4,1,0,42,1,43,2
commontoolsinc,labs,314,https://github.com/commontoolsinc/labs/pull/314,MERGED,23,1054,634,1688,29,0,0,0,0,0
commontoolsinc,labs,498,https://github.com/commontoolsinc/labs/pull/498,MERGED,1,2,2,4,0,0,579,333,912,8
commontoolsinc,labs,931,https://github.com/commontoolsinc/labs/pull/931,MERGED,8,889,406,1295,4,4,0,0,0,0
compiler-explorer,infra,1589,https://github.com/compiler-explorer/infra/pull/1589,MERGED,1,12,6,18,0,0,239,192,431,3
dbieber,GoNoteGo,53,https://github.com/dbieber/GoNoteGo/pull/53,MERGED,35,637,477,1114,0,0,44,1,45,1
dbieber,GoNoteGo,54,https://github.com/dbieber/GoNoteGo/pull/54,MERGED,1,24,0,24,0,0,9,3,12,1
dbieber,GoNoteGo,55,https://github.com/dbieber/GoNoteGo/pull/55,MERGED,1,1,2,3,0,0,15,11,26,2
dbieber,GoNoteGo,57,https://github.com/dbieber/GoNoteGo/pull/57,MERGED,4,5,3,8,1,0,15,0,15,1
dbieber,GoNoteGo,58,https://github.com/dbieber/GoNoteGo/pull/58,MERGED,1,2,0,2,0,0,4,2,6,2
dbieber,GoNoteGo,60,https://github.com/dbieber/GoNoteGo/pull/60,MERGED,9,43,41,84,8,0,0,198,198,5
dbieber,GoNoteGo,61,https://github.com/dbieber/GoNoteGo/pull/61,MERGED,2,17,7,24,1,0,134,5,139,5
dbieber,GoNoteGo,62,https://github.com/dbieber/GoNoteGo/pull/62,MERGED,5,14,11,25,3,0,19,0,19,1
dbieber,GoNoteGo,64,https://github.com/dbieber/GoNoteGo/pull/64,MERGED,1,0,1,1,1,0,9,9,18,2
dbieber,GoNoteGo,69,https://github.com/dbieber/GoNoteGo/pull/69,MERGED,31,113,61,174,2,4,6266,134,6400,28
defog-ai,defog-python,54,https://github.com/defog-ai/defog-python/pull/54,MERGED,3,81,75,156,1,0,130,0,130,1
defog-ai,introspect,64,https://github.com/defog-ai/introspect/pull/64,MERGED,12,99,222,321,19,0,2,823,825,9
defog-ai,introspect,472,https://github.com/defog-ai/introspect/pull/472,MERGED,1,4,1,5,1,0,12,10,22,2
devondragon,SpringUserFramework,168,https://github.com/devondragon/SpringUserFramework/pull/168,MERGED,2,2,3,5,0,0,359,46,405,4
douvy,btc-tooling,23,https://github.com/douvy/btc-tooling/pull/23,MERGED,1,203,13,216,2,1,622,872,1494,3
dxos,dxos,6916,https://github.com/dxos/dxos/pull/6916,MERGED,1,1,0,1,0,0,17,2,19,1
expectedparrot,edsl,479,https://github.com/expectedparrot/edsl/pull/479,MERGED,8,133,83,216,12,0,97,41,138,3
expectedparrot,edsl,484,https://github.com/expectedparrot/edsl/pull/484,MERGED,1,1,1,2,0,0,172,105,277,4
expectedparrot,edsl,520,https://github.com/expectedparrot/edsl/pull/520,MERGED,3,485,417,902,2,0,614,118,732,11
expectedparrot,edsl,615,https://github.com/expectedparrot/edsl/pull/615,MERGED,1,7,4,11,0,0,18888,5525,24413,8
expectedparrot,edsl,1772,https://github.com/expectedparrot/edsl/pull/1772,MERGED,12,2888,984,3872,12,9,260,66,326,7
fossas,fossa-cli,1424,https://github.com/fossas/fossa-cli/pull/1424,MERGED,4,5,6,11,1,0,143,23,166,5
giselles-ai,giselle,28,https://github.com/giselles-ai/giselle/pull/28,MERGED,1,1,0,1,0,0,60,17,77,6
giselles-ai,giselle,47,https://github.com/giselles-ai/giselle/pull/47,MERGED,1,1,1,2,0,0,131,138,269,5
giselles-ai,giselle,48,https://github.com/giselles-ai/giselle/pull/48,MERGED,2,1,3,4,0,0,2367,154,2521,19
giselles-ai,giselle,54,https://github.com/giselles-ai/giselle/pull/54,MERGED,11,244,860,1104,2,0,1458,483,1941,27
giselles-ai,giselle,72,https://github.com/giselles-ai/giselle/pull/72,MERGED,1,16,1143,1159,1,0,4,4,8,3
giselles-ai,giselle,81,https://github.com/giselles-ai/giselle/pull/81,MERGED,1,1,1,2,0,0,193,57,250,8
giselles-ai,giselle,106,https://github.com/giselles-ai/giselle/pull/106,MERGED,9,7649,2114,9763,19,0,219,48,267,6
giselles-ai,giselle,129,https://github.com/giselles-ai/giselle/pull/129,MERGED,5,107,16,123,0,0,6341,2103,8444,38
giselles-ai,giselle,149,https://github.com/giselles-ai/giselle/pull/149,MERGED,2,1760,0,1760,7,0,0,0,0,0
giselles-ai,giselle,161,https://github.com/giselles-ai/giselle/pull/161,MERGED,1,1,1,2,0,0,254,42,296,4
giselles-ai,giselle,184,https://github.com/giselles-ai/giselle/pull/184,MERGED,1,7,1,8,0,0,27,14,41,2
giselles-ai,giselle,201,https://github.com/giselles-ai/giselle/pull/201,MERGED,3,105,63,168,1,0,363,15,378,9
giselles-ai,giselle,203,https://github.com/giselles-ai/giselle/pull/203,MERGED,1,20,9,29,1,0,65,30,95,2
giselles-ai,giselle,270,https://github.com/giselles-ai/giselle/pull/270,MERGED,5,4250,4725,8975,0,0,6972,1006,7978,29
giselles-ai,giselle,280,https://github.com/giselles-ai/giselle/pull/280,MERGED,1,4,0,4,2,0,2148,1,2149,4
giselles-ai,giselle,285,https://github.com/giselles-ai/giselle/pull/285,MERGED,3,12,1,13,2,0,9207,9202,18409,108
giselles-ai,giselle,299,https://github.com/giselles-ai/giselle/pull/299,MERGED,4,1051,1110,2161,1,0,3172,0,3172,30
giselles-ai,giselle,309,https://github.com/giselles-ai/giselle/pull/309,MERGED,2,48,43,91,2,0,5479,591,6070,63
giselles-ai,giselle,397,https://github.com/giselles-ai/giselle/pull/397,MERGED,2,9,9,18,0,0,111,94,205,15
giselles-ai,giselle,414,https://github.com/giselles-ai/giselle/pull/414,MERGED,1,1,227,228,2,0,500,242,742,22
giselles-ai,giselle,416,https://github.com/giselles-ai/giselle/pull/416,MERGED,2,24,46,70,1,0,43,4,47,4
giselles-ai,giselle,420,https://github.com/giselles-ai/giselle/pull/420,MERGED,22,1721,2458,4179,96,0,0,0,0,0
giselles-ai,giselle,421,https://github.com/giselles-ai/giselle/pull/421,MERGED,3,66,4,70,1,0,1316,34,1350,18
giselles-ai,giselle,465,https://github.com/giselles-ai/giselle/pull/465,MERGED,3,165,4,169,4,0,190,10,200,20
giselles-ai,giselle,499,https://github.com/giselles-ai/giselle/pull/499,MERGED,7,52,55,107,2,0,4750,2020,6770,91
giselles-ai,giselle,584,https://github.com/giselles-ai/giselle/pull/584,MERGED,5,8,2629,2637,15,0,0,7061,7061,55
giselles-ai,giselle,684,https://github.com/giselles-ai/giselle/pull/684,MERGED,14,614,118,732,15,0,398,30,428,12
giselles-ai,giselle,707,https://github.com/giselles-ai/giselle/pull/707,MERGED,3,14,9,23,2,0,204,52,256,10
giselles-ai,giselle,708,https://github.com/giselles-ai/giselle/pull/708,MERGED,1,2,2,4,1,0,109,144,253,4
giselles-ai,giselle,755,https://github.com/giselles-ai/giselle/pull/755,MERGED,2,8,6,14,1,0,668,156,824,36
giselles-ai,giselle,764,https://github.com/giselles-ai/giselle/pull/764,MERGED,1,1,1,2,0,0,140,8,148,6
giselles-ai,giselle,785,https://github.com/giselles-ai/giselle/pull/785,MERGED,1,2,1,3,0,0,280,87,367,14
github,github-mcp-server,356,https://github.com/github/github-mcp-server/pull/356,MERGED,7,832,91,923,4,2,0,0,0,0
goodjoblife,GoodJobShare,1322,https://github.com/goodjoblife/GoodJobShare/pull/1322,MERGED,1,4,14,18,0,0,111,129,240,6
grafana,loki,13731,https://github.com/grafana/loki/pull/13731,MERGED,21,3107,690,3797,27,0,0,0,0,0
grapeot,web_agentic_ai,26,https://github.com/grapeot/web_agentic_ai/pull/26,MERGED,6,1864,1605,3469,11,0,413,116,529,11
hicommonwealth,commonwealth,11320,https://github.com/hicommonwealth/commonwealth/pull/11320,MERGED,1,3,2,5,0,0,1,2,3,1
honeycombio,honeycomb-mcp,28,https://github.com/honeycombio/honeycomb-mcp/pull/28,MERGED,3,311,101,412,1,2,209,73,282,4
honeycombio,honeycomb-mcp,36,https://github.com/honeycombio/honeycomb-mcp/pull/36,MERGED,20,1991,702,2693,11,17,840,101,941,8
honeycombio,honeycomb-mcp,44,https://github.com/honeycombio/honeycomb-mcp/pull/44,MERGED,3,25,12,37,2,0,396,172,568,10
honeycombio,honeycomb-mcp,54,https://github.com/honeycombio/honeycomb-mcp/pull/54,MERGED,2,313,19,332,3,0,552,608,1160,19
julep-ai,julep,391,https://github.com/julep-ai/julep/pull/391,MERGED,6,429,85,514,10,0,750,372,1122,17
llun,activities.next,73,https://github.com/llun/activities.next/pull/73,MERGED,2,20,14,34,0,0,759,883,1642,63
llun,activities.next,80,https://github.com/llun/activities.next/pull/80,MERGED,1,1,1,2,0,0,87,6,93,6
llun,activities.next,88,https://github.com/llun/activities.next/pull/88,MERGED,1,1,3,4,0,0,58,13,71,4
llun,activities.next,93,https://github.com/llun/activities.next/pull/93,MERGED,4,235,13,248,1,0,55,25,80,4
llun,activities.next,95,https://github.com/llun/activities.next/pull/95,MERGED,4,28,161,189,0,0,468,30,498,9
llun,feeds,428,https://github.com/llun/feeds/pull/428,MERGED,1,2,1,3,1,0,118,75,193,17
llun,feeds,498,https://github.com/llun/feeds/pull/498,MERGED,2,3,3,6,3,0,2,2,4,2
ltwlf,json-diff-ts,208,https://github.com/ltwlf/json-diff-ts/pull/208,MERGED,1,207,35,242,1,0,62,1,63,3
mattermost,mattermost,26997,https://github.com/mattermost/mattermost/pull/26997,MERGED,3,349,35,384,2,0,124,5,129,8
mattermost,mattermost,27368,https://github.com/mattermost/mattermost/pull/27368,MERGED,1,4,4,8,0,0,117,35,152,2
mattermost,mattermost,28291,https://github.com/mattermost/mattermost/pull/28291,MERGED,1,9,13,22,2,0,4,5,9,1
mattermost,mattermost,28324,https://github.com/mattermost/mattermost/pull/28324,MERGED,4,10,9,19,3,0,16,5,21,2
mattermost,mattermost,28333,https://github.com/mattermost/mattermost/pull/28333,MERGED,2,18,5,23,0,0,26,0,26,1
mattermost,mattermost,29506,https://github.com/mattermost/mattermost/pull/29506,MERGED,2,1,9,10,0,0,30,5,35,2
mattermost,mattermost,30060,https://github.com/mattermost/mattermost/pull/30060,MERGED,5,260,89,349,5,0,43,21,64,1
mattermost,mattermost,30295,https://github.com/mattermost/mattermost/pull/30295,MERGED,3,3923,1928,5851,159,0,136,112,248,11
mattermost,mattermost,30672,https://github.com/mattermost/mattermost/pull/30672,MERGED,5,600,557,1157,34,0,186,1,187,3
mattermost,mattermost,30789,https://github.com/mattermost/mattermost/pull/30789,MERGED,3,126,23,149,5,0,0,0,0,0
mattermost,mattermost-mobile,8795,https://github.com/mattermost/mattermost-mobile/pull/8795,MERGED,2,36,5,41,2,2,0,0,0,0
mattgodbolt,specbolt,15,https://github.com/mattgodbolt/specbolt/pull/15,MERGED,11,219,224,443,8,0,1274,76,1350,11
mc-bench,mc-bench-backend,5,https://github.com/mc-bench/mc-bench-backend/pull/5,MERGED,2,2642,107,2749,56,0,0,0,0,0
mc-bench,mc-bench-backend,121,https://github.com/mc-bench/mc-bench-backend/pull/121,MERGED,2,668,40,708,5,0,0,0,0,0
mc-bench,mc-bench-frontend,2,https://github.com/mc-bench/mc-bench-frontend/pull/2,MERGED,2,61,2,63,11,0,1286,25,1311,22
modelcontextprotocol,python-sdk,206,https://github.com/modelcontextprotocol/python-sdk/pull/206,MERGED,5,113,56,169,5,0,0,0,0,0
modelcontextprotocol,python-sdk,515,https://github.com/modelcontextprotocol/python-sdk/pull/515,MERGED,2,12,13,25,0,0,113,42,155,4
monarch-initiative,aurelian,5,https://github.com/monarch-initiative/aurelian/pull/5,MERGED,2,101,72,173,1,0,2602,226,2828,8
monarch-initiative,aurelian,8,https://github.com/monarch-initiative/aurelian/pull/8,MERGED,7,24,12,36,0,0,62,1,63,1
monarch-initiative,aurelian,17,https://github.com/monarch-initiative/aurelian/pull/17,MERGED,8,2775,248,3023,29,4,7898,2721,10619,117
natolambert,rlhf-book,19,https://github.com/natolambert/rlhf-book/pull/19,MERGED,3,268,59,327,2,0,32,5,37,4
natolambert,rlhf-book,34,https://github.com/natolambert/rlhf-book/pull/34,MERGED,1,2,5,7,0,0,125,4,129,3
natolambert,rlhf-book,50,https://github.com/natolambert/rlhf-book/pull/50,MERGED,2,98,8,106,3,0,11,5,16,2
natolambert,rlhf-book,99,https://github.com/natolambert/rlhf-book/pull/99,MERGED,2,228,8,236,1,0,35,3,38,5
nerfstudio-project,viser,214,https://github.com/nerfstudio-project/viser/pull/214,MERGED,11,1360,1477,2837,72,0,0,0,0,0
nerfstudio-project,viser,228,https://github.com/nerfstudio-project/viser/pull/228,MERGED,3,93,87,180,3,0,10,21,31,2
nerfstudio-project,viser,251,https://github.com/nerfstudio-project/viser/pull/251,MERGED,1,0,1,1,0,0,207,62,269,1
nerfstudio-project,viser,290,https://github.com/nerfstudio-project/viser/pull/290,MERGED,1,4,1,5,0,0,143,60,203,8
nerfstudio-project,viser,356,https://github.com/nerfstudio-project/viser/pull/356,MERGED,1,1,1,2,0,0,142,7,149,7
nerfstudio-project,viser,377,https://github.com/nerfstudio-project/viser/pull/377,MERGED,1,1,1,2,1,0,70,30,100,5
obophenotype,uberon,3507,https://github.com/obophenotype/uberon/pull/3507,MERGED,4,14,3,17,1,0,0,0,0,0
openvm-org,openvm,936,https://github.com/openvm-org/openvm/pull/936,MERGED,1,10,10,20,5,0,7,2,9,1
oven-sh,bun,17779,https://github.com/oven-sh/bun/pull/17779,MERGED,1,1,1,2,0,0,74,1,75,2
poap-xyz,poap.js,136,https://github.com/poap-xyz/poap.js/pull/136,MERGED,1,5,5,10,0,0,17,16,33,3
portone-io,developers.portone.io,814,https://github.com/portone-io/developers.portone.io/pull/814,MERGED,2,200,190,390,28,0,0,0,0,0
potpie-ai,potpie-ui,129,https://github.com/potpie-ai/potpie-ui/pull/129,MERGED,1,8,10,18,0,0,214,210,424,3
pozar87,apts,8,https://github.com/pozar87/apts/pull/8,MERGED,2,3,2,5,0,0,39,0,39,1
pozar87,apts,10,https://github.com/pozar87/apts/pull/10,MERGED,1,208,212,420,2,0,1967,2121,4088,13
prescient-design,cortex,19,https://github.com/prescient-design/cortex/pull/19,MERGED,4,751,3,754,4,0,985,32,1017,11
py-typedlogic,py-typedlogic,1,https://github.com/py-typedlogic/py-typedlogic/pull/1,MERGED,4,1924,1268,3192,98,0,6980,1096,8076,56
py-typedlogic,py-typedlogic,2,https://github.com/py-typedlogic/py-typedlogic/pull/2,MERGED,5,319,275,594,1,0,2790,1324,4114,63
pymc-devs,pytensor,918,https://github.com/pymc-devs/pytensor/pull/918,MERGED,10,67,26,93,2,0,0,0,0,0
pymc-devs,pytensor,966,https://github.com/pymc-devs/pytensor/pull/966,MERGED,6,12,9,21,0,0,1,1,2,1
pytorch,test-infra,6336,https://github.com/pytorch/test-infra/pull/6336,MERGED,1,1,1,2,0,0,56,0,56,1
qltysh,qlty,1281,https://github.com/qltysh/qlty/pull/1281,MERGED,1,5,5,10,5,0,859,5,864,4
qltysh,qlty,1992,https://github.com/qltysh/qlty/pull/1992,MERGED,1,1,0,1,0,0,26,25,51,6
renlabs-dev,torus-ts,130,https://github.com/renlabs-dev/torus-ts/pull/130,MERGED,14,6381,6094,12475,295,0,51,14,65,3
rishikanthc,Scriberr,47,https://github.com/rishikanthc/Scriberr/pull/47,MERGED,3,104,31,135,1,0,39,17,56,5
rollbar,rollbar.js,1169,https://github.com/rollbar/rollbar.js/pull/1169,MERGED,6,668,57,725,6,0,0,0,0,0
sakaiproject,sakai,12599,https://github.com/sakaiproject/sakai/pull/12599,MERGED,1,2,2,4,1,0,1,4,5,1
sakaiproject,sakai,12979,https://github.com/sakaiproject/sakai/pull/12979,MERGED,1,6,4,10,0,0,9,6,15,1
shopwareLabs,extension-verifier,19,https://github.com/shopwareLabs/extension-verifier/pull/19,MERGED,6,521,139,660,28,0,258,223,481,12
sourcegraph,cody,5156,https://github.com/sourcegraph/cody/pull/5156,MERGED,1,1,3,4,0,0,24,19,43,1
synapsecns,sanguine,2611,https://github.com/synapsecns/sanguine/pull/2611,MERGED,7,446,31,477,3,0,20407,17248,37655,78
synapsecns,sanguine,2637,https://github.com/synapsecns/sanguine/pull/2637,MERGED,1,1,0,1,1,0,3080,29,3109,29
synapsecns,sanguine,2901,https://github.com/synapsecns/sanguine/pull/2901,MERGED,4,5,10,15,0,0,18,0,18,6
thefrontside,effection,988,https://github.com/thefrontside/effection/pull/988,MERGED,1,2,3,5,0,0,25,4,29,2
tomakado,dumbql,5,https://github.com/tomakado/dumbql/pull/5,MERGED,3,50,9,59,1,0,18,10,28,1
tomakado,dumbql,6,https://github.com/tomakado/dumbql/pull/6,MERGED,1,2,3,5,0,0,3,0,3,1
umputun,tg-spam,195,https://github.com/umputun/tg-spam/pull/195,MERGED,1,21,5,26,1,0,15961,813,16774,162
utensils,mcp-nixos,1,https://github.com/utensils/mcp-nixos/pull/1,MERGED,6,3009,3252,6261,104,4,4970,5214,10184,38
utensils,mcp-nixos,5,https://github.com/utensils/mcp-nixos/pull/5,MERGED,2,27,11,38,2,2,1076,104,1180,13
utensils,mcp-nixos,7,https://github.com/utensils/mcp-nixos/pull/7,MERGED,6,1399,213,1612,15,6,1634,0,1634,41
utensils,mcp-nixos,8,https://github.com/utensils/mcp-nixos/pull/8,MERGED,17,686,1000,1686,15,7,2409,822,3231,14
yumemi-inc,Tart,36,https://github.com/yumemi-inc/Tart/pull/36,MERGED,3,89,60,149,4,0,0,0,0,0
yumemi-inc,Tart,66,https://github.com/yumemi-inc/Tart/pull/66,MERGED,5,159,603,762,20,0,0,0,0,0
yumemi-inc,Tart,69,https://github.com/yumemi-inc/Tart/pull/69,MERGED,6,226,25,251,8,0,32,0,32,3
yumemi-inc,Tart,75,https://github.com/yumemi-inc/Tart/pull/75,MERGED,2,39,40,79,0,0,207,0,207,1
zenml-io,zenml,2725,https://github.com/zenml-io/zenml/pull/2725,MERGED,1,2,1,3,0,0,8,1,9,1
